++++++++++++++++++++++
+                    +
+                    +
+       +AAAAA+      +
+      AAA 0 AAA a   +  
+       +AAAAA+      +
+                    +
+                    +
+                    +
++++++++++++++++++++++
