++++++++++++++++++++++
+ A                  +
+AA                  +
+           +++      +
+       0   A a+     +
+          ++++      +
+                    +
+                    +
+                    +
++++++++++++++++++++++
